100 70
1111111111111111111111111111111111111111111111111111111111111111111111
1111111111111111111111000000000011111111111111111111111111111111111111
1111111111111111111111000000000011111111111111111111111111111111111111
1111111111111111111111000000000000000000000000000000001111111111111111
1111111111111111111111000000000000000000000000000000001111111111111111
1111111111111111111111000000000000000000000000000000000011111111111111
1111111111111111111111000000000000000000000000000000000011111111111111
1111111111111111111111000000000000000000000000000000000011111111111111
1111111111111111111000000000000000000000000000000000000011111111111111
1111111111111110000000000000000000001111100000000000000011111111111111
1111111111110000000000000000000000001111100000000000000011111111111111
1111111100000000000000000000000000001111100000000000000011111111111111
1111100000000000000000000000000000001111100000000000000011111111111111
1110000000000000000000000000000000000000000000000000000011111111111111
1000000000000000000000000000000000000000000000000000000011111111111111
1000000000000000000000000000000000000000000000000000000011111111111111
1000000000000000000000000000000000000000000000000000000011111111111111
1000000000000000000000000000000000000000000000000000000011111111111111
1000000000000000000000000000000000000000000000000000000011111111111111
1000000000000000000000000000000000000000000000000000000011111111111111
1000000000000000000000000000000000000000000000000000000011111111111111
1000000000000000000000000000000011111111111111111111111111111111111111
1000000000000000000000000000000011111111111111111111111111111111111111
1000000000000000000000000000000011111111111111111111111111111111111111
1000000000000000000000000000000011111111111111111111111111111111111111
1000000000000000000000000000000011111111111111111111111111111111111111
1000000000000000000000000000000011111111111111111111111111111111111111
1000000000000000000000000000000011111111111111111111111111111111111111
1000000000000000000000000000000011111111111111111111111111111111111111
1000000000000000000000000000000011111111111111111111111111111111111111
1000000000000000000000000000000011111111111111111111111111111111111111
1000000000000000000000000000000011111111111111111111111111111111111111
1000000000000000000000000000000011111111111111111111111111111111111111
1000000000000000000000000000000011111111111111111111111111111111111111
1000000000000000000000000000000011111111111111111111111111111111111111
1000000000000000000000000000000011111111111111111111111111111111111111
1000000000000000000000000000000011111111111111111111111111111111111111
1000000000000111100000000000000011111111111111111111111111111111111111
1000000000000111100000000000000011111111111111111111111111111111111111
1000000000000111100000000000000011111111111111111111111111111111111111
1000000000000111100000000000000011111111111111111111111111111111111111
1000000000000111100000000000000011111111111111111111111111111111111111
1000000000000000000000000000000011111111111111111111111111111111111111
1000000000000000000000000000000011111111111111111111111111111111111111
1000000000000000000000000000000011111111111111111111111111111111111111
1000000000000000000000000000000011111111111111111111111111111111111111
1000000000000000000000000000000011111111111111111111111111111111111111
1000000000000000000000000000000011111111111111111111111111111111111111
1000000000000000000000000000000011111111111111111111111111111111111111
1000000000000000000000000000000011111111111111111111111111111111111111
1000000000000000000000000000000011111111111111111111111111111111111111
1000000000000000000000000000000011111111111111111111111111111111111111
1000000000000000000000000000000011111111111111111111111111111111111111
1000000000000000000000000000001111111111111111111111111111111111111111
1000000000000000000000000000001111111111111111111111111111111111111111
1000000000000000000000000000000011111111111111111111111111111111111111
1000000000000000000000000000000011111111111111111111111111111111111111
1000000000000000000000000000000011111111111111111111111111111111111111
1000000000000000000000000000000011111111111111111111111111111111111111
1000000000000000000000000000000011111111111111111111111111111111111111
1000000000000000000000000000000011111111111111111111111111111111111111
1000000000000000000000000000000011111111111111111111111111111111111111
1000000000000000000000000000000011111111111111111111111111111111111111
1000000000000000000000000000000011111111111111111111111111111111111111
1000000000000000000000000000000011111111111111111111111111111111111111
1000000000000000000000000000000011111111111111111111111111111111111111
1000000000000000000000000000000011111111111111111111111111111111111111
1000000000000000000000000000000011111111111111111111111111111111111111
1000000000000000000000000000000011111111111111111111111111111111111111
1000000000000000000000000000000011111111111111111111111111111111111111
1000000000000000000000000000000011111111111111111111111111111111111111
1000000000000000000000000000000011111111111111111111111111111111111111
1000000000000000000000000000000011111111111111111111111111111111111111
1000000000000000000000000000000011111111111111111111111111111111111111
1000000000000000000000000000000011111111111111111111111111111111111111
1000000000000000000000000000000011111111111111111111111111111111111111
1000000000000000000000000000000011111111111111111111111111111111111111
1000000000000000000000000000000011111111111111111111111111111111111111
1000000000000000000000000000000011111111111111111111111111111111111111
1000000000000000000000000000000011111111111111111111111111111111111111
1000000000000000000000000000000011111111111111111111111111111111111111
1000000000000000000000000000000011111111111111111111111111111111111111
1000000000000000000000000000000011111111111111111111111111111111111111
1000000000000000000000000000000011111111111111111111111111111111111111
1000000000000000000000000000000011111111111111111111111111111111111111
1000000000000000000000000000000011111111111111111111111111111111111111
1000000000000000000000000000000011111111111111111111111111111111111111
1000000000000000000000000000000011111111111111111111111111111111111111
1000000000000000000000000000000011111111111111111111111111111111111111
1000000000000000000000000000000011111111111111111111111111111111111111
1000000000000000000000000000000011111111111111111111111111111111111111
1000000000000000000000000000000011111111111111111111111111111111111111
1000000000000000000000000000000011111111111111111111111111111111111111
1000000000000000000000000000000011111111111111111111111111111111111111
1000000000000000000000000000000011111111111111111111111111111111111111
1000000000000000000000000000000011111111111111111111111111111111111111
1000000000000000000000000000000011111111111111111111111111111111111111
1000000000000000000000000000000011111111111111111111111111111111111111
1000000000000000000000000000000011111111111111111111111111111111111111
1111111111111111111111111111111111111111111111111111111111111111111111
