60 56
11111111111111111111100000000001111111111111111111111111
11111111111111111111100000000001111111111111111111111111
11111111111111111111100000000001111111111111111111111111
11111111111111111111100000000000000000000000000000000011
11111111111111111111100000000000000000000000000000000011
11111111111111111111100000000000000000000000000000000000
11111111111111111111100000000000000000000000000000000000
11111111111111111111100000000000000000000000000000000000
11111111111111110000000000000000000000000000000000000000
11111111111110000000000000000000000000000000000000000000
11111111100000000000000000000000000000000000000000000000
11111100000000000000000000000000000000000000000000000000
11000000000000000000000000000000000000111100000000000000
00000000000000000000000000000000000000111100000000000000
00000000000000000000000000000000000000111100000000000000
00000000000000000000000000000000000000111100000000000000
00000000000000000000000000000000000000111100000000000000
00000000000000000000000000000000000000000000000000000000
00000000000000000000000000000000000000000000000000000000
00000000000000000000000000000000000000000000000000000000
00000000000000000000000000000000000000000000000000000000
00000000000000000000000000000001111111111111111111111111
00000000000000000000000000000001111111111111111111111111
00000000000000000000000000000001111111111111111111111111
00000000000000000000000000000001111111111111111111111111
00000000000000000000000000000001111111111111111111111111
00000000000000000000000000000001111111111111111111111111
00000000000000000000000000000001111111111111111111111111
00000000000000000000000000000001111111111111111111111111
00000000000000000000000000000001111111111111111111111111
00000000000000000000000000000001111111111111111111111111
00000000000000000000000000000001111111111111111111111111
00000000000000000000000000000001111111111111111111111111
00000000000000000000000000000001111111111111111111111111
00000000000000000000000000000001111111111111111111111111
00000000000000000000000000000001111111111111111111111111
00000000000000000000000000000001111111111111111111111111
00000000000000000000000000000001111111111111111111111111
00000000000000000000000000000001111111111111111111111111
00000000000000000000000000000001111111111111111111111111
00000000000000000000000000000001111111111111111111111111
00000000000011110000000000000001111111111111111111111111
00000000000011110000000000000001111111111111111111111111
00000000000011110000000000000001111111111111111111111111
00000000000011110000000000000001111111111111111111111111
00000000000011110000000000000001111111111111111111111111
00000000000000000000000000000001111111111111111111111111
00000000000000000000000000000001111111111111111111111111
00000000000000000000000000000001111111111111111111111111
00000000000000000000000000000001111111111111111111111111
00000000000000000000000000000001111111111111111111111111
00000000000000000000000000000001111111111111111111111111
00000000000000000000000000000001111111111111111111111111
00000000000000000000000000000001111111111111111111111111
00000000000000000000000000000001111111111111111111111111
00000000000000000000000000000001111111111111111111111111
00000000000000000000000000000001111111111111111111111111
00000000000000000000000000000001111111111111111111111111
11000000000000000000000000000111111111111111111111111111
11000000000000000000000000000111111111111111111111111111
