220 100
1111111111111111111111111111111111111111111111111111111111111111111111111111111111111111111111111111
1111111111111111111111111111111111111111111111111111111111111111111111111111111111111111111111111111
1111111111111111111111111111111111111111111111111111111111111111111111111111111111111111111111111111
1111111111111111111111111111111111111111111111111111111111111111111111111111111111111111111111111111
1111111111111111111111111111111111111111111111111111111111111111111111111111111111111111111111111111
1111111111111111111111111111111111111111111111111111111111111111111111111111111111111111111111111111
1111111111111111111111111111111111111111111111111111111111111111111111111111111111111111111111111111
1111111111111111111111111111111111111111111111111111111111111111111111111111111111111111111111111111
1111111111111111111111111111111111111111111111111111111111111111111111111111111111111111111111111111
1111111111111111111111111111111111111111111111111111111111111111111111111111111111111111111111111111
1111111111111111111111111111111111111111111111111111111111111111111111111111111111111111111111111111
1111111111111111111111111111111111111111111111111111111111111111111111111111111111111111111111111111
1111111111111111111111111111111111111111111111111111111111111111111111111111111111111111111111111111
1111111111111111111111111111111111111000000000000000000000000000000000000000000000000000000000000001
1111111111111111111111111111111111111000000000000000000000000000000000000000000000000000000000000001
1111111111111111111111111111111111111000000000000000000000000000000000000000000000000000000000000001
1111111111111111111111111111111111111000000000000000000000000000000000000000000000000000000000000001
1111111111111111111111111111111111111000000000000000000000000000000000000000000000000000000000000001
1111111111111111111111111111111111111000000000000000000000000000000000000000000000000000000000000001
1111111111111111111111111111111111111000000000000000000000000000000000000000000000000000000000000001
1111111111111111111111111111111111111000000000000000000000000000000000000000000000000000000000000001
1111111111111111111111111111111111111000000000000000000000000000000000000000000000000000000000000001
1111111111111111111111111111111111111000000000000000000000000000000000000000000000000000000000000001
1111111111111111111111111111111111111000000000000000000000000000000000000000000000000000000000000001
1111111111111111111111111111111111111000000000000000000000000000000000000000000000000000000000000001
1111111111111111111111111111111111111000000000000000000000000000000000000000000000000000000000000001
1111111111111111111111111111111111111000000000000000000000000000000000000000000000000000000000000001
1111111111111111111111111111111111111000000000000000000000000000000000000000000000000000000000000001
1111111111111111111111111111111111111000000000000000000000000000000000000000000000000000000000000001
1111111111111111111111111111111111111110000000000000000000000000000000001111111110000000000000000001
1111111111111111111111111111111111111110000000000000000000000000000000001111111110000000000000000001
1111000000000000000000000000000111111110000000000000000000000000000000001111111110000000000000000001
1111000000000000000000000000000111111110000000000000000000000000000000001111111110000000000000000001
1111000000000000000000000000000111100000000000000000000000000000000000001111111110000000000000000001
1111000000000000000000000000000111100000000000000000000000000000000000001111111110000000000000000001
1111000000000000000000000000000111100000000000000000000000000000000000000000000000000000000000000001
1111000000000000000000000000000111100000000000000000000000000000000000000000000000000000000000000001
1111000000000000000000000000000000000000000000000000000000000000000000000000000000000000000000000001
1111000000000000000000000000000000000000000000000000000000000000000000000000000000000000000000000001
1111000000000000000000000000000000000000000000000000000000000000000000000000000000000000000000000001
1111000000000000000000000000000000000000000000000000000000000000000000000000000000000000000000000001
1111000000000000000000000000000000000000000000000000000000000000000000000000000000000000000000000001
1111000000000000000000000000000000000000000000000000000000000000000000000000000000000000000000000001
1111000000000000000000000000000000000000000000000000000000000000000000000000000000000000000000000001
1111000000000000000000000000000000000000000000000000000000000000000000000000000000000000000000000001
1111000000000000000000000000000000000000000000000000000000000000000000000000000000000000000000000001
1111000000000000000000000000000000000000000000000000000000000000000000000000000000000000000000000001
1111000000000000000000000000000000000000000000000000000000000000000000000000000000000000000000000001
1111000000000000000000000000000000000000000000000000000000000000000000000000000000000000000000000001
1111000000000000000000000000000000000000000000000000000000000000000000000000000000000000000000000001
1111000000000000000000000000000000000000000000000000000000000000000000000000000000000000000000000001
1111000000000000000000000000000000011111111111111111111111111111111111111111111110000000000000000001
1111000000000000000000000000000000011111111111111111111111111111111111111111111110000000000000000001
1111000000000000000000000000000000011111111111111111111111111111111111111111111110000000000000000001
1111000000000000000000000000000000011111111111111111111111111111111111111111111110000000000000000001
1111000000000000000000000000000000011111111111111111111111111111111111111111111110000000000000000001
1111000000000000000000000000000000011111111111111111111111111111111111111111111110000000000000000001
1111000000000000000000000000000000011111111111111111111111111111111111111111111110000000000000000001
1111000000000000000000000000000000011111111111111111111111111111111111111111111110000000000000000001
1111000000000000000000000000000000011111111111111111111111111111111111111111111110000000000000000001
1111000000000000000000000000000000011111111111111111111111111111111111111111111110000000000000000001
1111000000000000000000000000111100011111111111111111111111111111111111111111111110000000000000000001
1111000000000000000000000000111100011111111111111111111111111111111111111111111110000000000000000001
1111000000000000000000000000111100011111111111111111111111111111111111111111111110000000000000000001
1111000000000000000000000000111100011111111111111111111111111111111111111111111110000000000000000001
1111000000000000000000000000111100011111111111111111111111111111111111111111111110000000000000000001
1111000000000000000000000000111100011111111111111111111111111111111111111111111110000000000000000001
1111000000000000000000000000111100011111111111111111111111111111111111111111111110000000000000000001
1111000000000000000000000000111100011111111111111111111111111111111111111111111110000000000000000001
1111000000000000000000000000111100011111111111111111111111111111111111111111111110000000000000000001
1111000000000000000000000000111100011111111111111111111111111111111111111111111110000000000000000001
1111000000000000000000000000111100011111111111111111111111111111111111111111111110000000000000000001
1111000000000000000000000000111100011111111111111111111111111111111111111111111110000000000000000001
1111000000000000000000000000000000011111111111111111111111111111111111111111111110000000000000000001
1111000000000000000000000000000000011111111111111111111111111111111111111111111110000000000000000001
1111000000000000000000000000000000011111111111111111111111111111111111111111111110000000000000000001
1111000000000000000000000000000000011111111111111111111111111111111111111111111110000000000000000001
1111000000000000000000000000000000011111111111111111111111111111111111111111111110000000000000000001
1111000000000000000000000000000000011111111111111111111111111111111111111111111110000000000000000001
1111000000000000000000000000000000011111111111111111111111111111111111111111111110000000000000000001
1111000000000000000000000000000000011111111111111111111111111111111111111111111110000000000000000001
1111000000000000000000000000000000011111111111111111111111111111111111111111111110000000000000000001
1111000000000000000000000000000000011111111111111111111111111111111111111111111110000000000000000001
1111000000000000000000000000000000011111111111111111111111111111111111111111111110000000000000000001
1111000000000000000000000000000000011111111111111111111111111111111111111111111110000000000000000001
1111000000000000000000000000000000011111111111111111111111111111111111111111111110000000000000000001
1111000000000000000000000000000000011111111111111111111111111111111111111111111110000000000000000001
1111000000000000000000000000000000011111111111111111111111111111111111111111111110000000000000000001
1111000000000000000000000000000000011111111111111111111111111111111111111111111110000000000000000001
1111000000000000000000000000000000011111111111111111111111111111111111111111111110000000000000000001
1111000000000000000000000000000000011111111111111111111111111111111111111111111110000000000000000001
1111000000000000000000000000000000011111111111111111111111111111111111111111111110000000000000000001
1111000000000000000000000000000000011111111111111111111111111111111111111111111110000000000000000001
1111000000000000000000000000000000011111111111111111111111111111111111111111111110000000000000000001
1111000000000000000000000000000000011111111111111111111111111111111111111111111110000000000000000001
1111000000000000000000000000000000011111111111111111111111111111111111111111111110000000000000000001
1111000000000000000000000000000000011111111111111111111111111111111111111111111110000000000000000001
1111000000000000000000000000000000011111111111111111111111111111111111111111111110000000000000000001
1111000000000000000000000000000000011111111111111111111111111111111111111111111110000000000000000001
1111000000000000000000000000000000011111111111111111111111111111111111111111111110000000000000000001
1111000000000000000000000000000000011111111111111111111111111111111111111111111110000000000000000001
1111000000000000000000000000000000011111111111111111111111111111111111111111111110000000000000000001
1111000000000000000000000000000000011111111111111111111111111111111111111111111110000000000000000001
1111000000000000000000000000000000011111111111111111111111111111111111111111111110000000000000000001
1111000000000000000000000000000000011111111111111111111111111111111111111111111110000000000000000001
1111000000000000000000000000000000011111111111111111111111111111111111111111111110000000000000000001
1111000000000000000000000000000000011111111111111111111111111111111111111111111110000000000000000001
1111000000000000000000000000000000011111111111111111111111111111111111111111111110000000000000000001
1111000000000000000000000000000000011111111111111111111111111111111111111111111110000000000000000001
1111000000000000000000000000000000011111111111111111111111111111111111111111111110000000000000000001
1111000000000000000000000000000000011111111111111111111111111111111111111111111110000000000000000001
1111000000000000000000000000000000011111111111111111111111111111111111111111111110000000000000000001
1111000000000000000000000000000000011111111111111111111111111111111111111111111110000000000000000001
1111000000000000000000000000000000011111111111111111111111111111111111111111111110000000000000000001
1111000000000000000000000000000000011111111111111111111111111111111111111111111110000000000000000001
1111000000000000000000000000000000011111111111111111111111111111111111111111111110000000000000000001
1111000000000000000000000000000000011111111111111111111111111111111111111111111110000000000000000001
1111000000000000000000000000000000011111111111111111111111111111111111111111111110000000000000000001
1111000000000000000000000000000000011111111111111111111111111111111111111111111110000000000000000001
1111000000000000000000000000000000011111111111111111111111111111111111111111111110000000000000000001
1111000000000000000000000000000000011111111111111111111111111111111111111111111110000000000000000001
1111000000000000000000000000000000011111111111111111111111111111111111111111111110000000000000000001
1111000000000000000000000000000000011111111111111111111111111111111111111111111110000000000000000001
1111000000000000000000000000000000011111111111111111111111111111111111111111111110000000000000000001
1111000000000000000000000000000000011111111111111111111111111111111111111111111110000000000000000001
1111000000000000000000000000000000011111111111111111111111111111111111111111111110000000000000000001
1111000000000000000000000000000000011111111111111111111111111111111111111111111110000000000000000001
1111000000000000000000000000000000011111111111111111111111111111111111111111111110000000000000000001
1111000000000000000000000000000000011111111111111111111111111111111111111111111110000000000000000001
1111000000000000000000000000000000011111111111111111111111111111111111111111111110000000000000000001
1111000000000000000000000000000000011111111111111111111111111111111111111111111110000000000000000001
1111000000000000000000000000000000011111111111111111111111111111111111111111111110000000000000000001
1111000000000000000000000000000000011111111111111111111111111111111111111111111110000000000000000001
1111000000000000000000000000000000011111111111111111111111111111111111111111111110000000000000000001
1111000000000000000000000000000000011111111111111111111111111111111111111111111110000000000000000001
1111000000000000000000000000000000011111111111111111111111111111111111111111111110000000000000000001
1111000000000000000000000000000000011111111111111111111111111111111111111111111110000000000000000001
1111000000000000000000000000000000011111111111111111111111111111111111111111111110000000000000000001
1111000000000000000000000000000000011111111111111111111111111111111111111111111110000000000000000001
1111000000000000000000000000000000011111111111111111111111111111111111111111111110000000000000000001
1111000000000000000000000000000000011111111111111111111111111111111111111111111110000000000000000001
1111000000000000000000000000000000011111111111111111111111111111111111111111111110000000000000000001
1111000000000000000000000000000000011111111111111111111111111111111111111111111110000000000000000001
1111000000000000000000000000000000011111111111111111111111111111111111111111111110000000000000000001
1111000000000000000000000000000000011111111111111111111111111111111111111111111110000000000000000001
1111000000000000000000000000000000011111111111111111111111111111111111111111111110000000000000000001
1111000000000000000000000000000000011111111111111111111111111111111111111111111110000000000000000001
1111000000000000000000000000000000011111111111111111111111111111111111111111111110000000000000000001
1111000000000000000000000000000000011111111111111111111111111111111111111111111110000000000000000001
1111000000000000000000000000000000011111111111111111111111111111111111111111111110000000000000000001
1111000000000000000000000000000000011111111111111111111111111111111111111111111110000000000000000001
1111000000000000000000000000000000011111111111111111111111111111111111111111111110000000000000000001
1111000000000000000000000000000000011111111111111111111111111111111111111111111110000000000000000001
1111000000000000000000000000000000011111111111111111111111111111111111111111111110000000000000000001
1111000000000000000000000000000000011111111111111111111111111111111111111111111110000000000000000001
1111000000000000000000000000000000011111111111111111111111111111111111111111111110000000000000000001
1111000000000000000000000000000000011111111111111111111111111111111111111111111110000000000000000001
1111000000000000000000000000000000011111111111111111111111111111111111111111111110000000000000000001
1111000000000000000000000000000000011111111111111111111111111111111111111111111110000000000000000001
1111000000000000000000000000000000011111111111111111111111111111111111111111111110000000000000000001
1111000000000000000000000000000000011111111111111111111111111111111111111111111110000000000000000001
1111000000000000000000000000000000011111111111111111111111111111111111111111111110000000000000000001
1111000000000000000000000000000000011111111111111111111111111111111111111111111110000000000000000001
1111000000000000000000000000000000011111111111111111111111111111111111111111111110000000000000000001
1111000000000000000000000000000000011111111111111111111111111111111111111111111110000000000000000001
1111000000000000000000000000000000011111111111111111111111111111111111111111111110000000000000000001
1111000000000000000000000000000000011111111111111111111111111111111111111111111110000000000000000001
1111000000000000000000000000000000011111111111111111111111111111111111111111111110000000000000000001
1111000000000000000000000000000000011111111111111111111111111111111111111111111110000000000000000001
1111000000000000000000000000000000011111111111111111111111111111111111111111111110000000000000000001
1111000000000000000000000000000000011111111111111111111111111111111111111111111110000000000000000001
1111000000000000000000000000000000011111111111111111111111111111111111111111111110000000000000000001
1111000000000000000000000000000000011111111111111111111111111111111111111111111110000000000000000001
1111000000000000000000000000000000011111111111111111111111111111111111111111111110000000000000000001
1111000000000000000000000000000000011111111111111111111111111111111111111111111110000000000000000001
1111000000000000000000000000000000011111111111111111111111111111111111111111111110000000000000000001
1111000000000000000000000000000000011111111111111111111111111111111111111111111110000000000000000001
1111000000000000000000000000000000011111111111111111111111111111111111111111111110000000000000000001
1111000000000000000000000000000000011111111111111111111111111111111111111111111110000000000000000001
1111000000000011110000000000000000011110000000000000000000000000000000000000000000000000000000000001
1111000000000011110000000000000000000000000000000000000000000000000000000000000000000000000000000001
1111000000000011110000000000000000000000000000000000000000000000000000000000000000000000000000000001
1111000000000011110000000000000000000000000000000000000000000000000000000000000000000000000000000001
1111000000000011110000000000000000000000000000000000000000000000000000000000000000000000000000000001
1111000000000011110000000000000000000000000000000000000000000000000000000000000000000000000000000001
1111000000000011110000000000000000000000000000000000000000000000000000000000000000000000000000000001
1111000000000011110000000000000000000000000000000000000000000000000000000000000000000000000000000001
1111000000000011110000000000000000000000000000000000000000000000000000000000000000000000000000000001
1111000000000011110000000000000000000000000000000000000000000000000000000000000000000000000000000001
1111000000000011110000000000000000000000000000000000000000000000000000000000000000000000000000000001
1111000000000011110000000000000000000000000000000000000000000000000000000000000000000000000000000001
1111000000000000000000000000000000000000000000000000000000000000000000000000000000000000000000000001
1111000000000000000000000000000000000000000000000000000000000000000000000000000000000000000000000001
1111000000000000000000000000000000000000000000000000000000000000000000000000000000000000000000000001
1111000000000000000000000000000000000000000000000000000000000000000000000000000000000000000000000001
1111000000000000000000000000000000000000000000000000000000000000000000000000000000000000000000000001
1111000000000000000000000000000000000000000000000000000000000000000000000000000000000000000000000001
1111000000000000000000000000000000000000000000000000000000000000000000000000000000000000000000000001
1111000000000000000000000000000000000000000000000000000000000000000000000000000000000000000000000001
1111000000000000000000000000000000011111111111111111111111111111111111111111100000000000000000000001
1111000000000000000000000000000000011111111111111111111111111111111111111111100000000000000000000001
1111000000000000000000000000000000011111111111111111111111111111111111111111100000000000000000000001
1111000000000000000000000000000000011111111111111111111111111111111111111111100000000000000000000001
1111000000000000000000000000000000011111111111111111111111111111111111111111100000000000000000000001
1111000000000000000000000000000000011111111111111111111111111111111111111111100000000000000000000001
1111000000000000000000000000000000011111111111111111111111111111111111111111100000000000000000000001
1111000000000000000000000000000000011111111111111111111111111111111111111111100000000000000000000001
1111000000000000000000000000000000011111111111111111111111111111111111111111100000000000000000000001
1111000000000000000000000000000000011111111111111111111111111111111111111111100000000000000000000001
1111000000000000000000000000000000011111111111111111111111111111111111111111100000000000000000000001
1111000000000000000000000000000000011111111111111111111111111111111111111111100000000000000000000001
1111000000000000000000000000000000011111111111111111111111111111111111111111100000000000000000000001
1111000000000000000000000000000000011111111111111111111111111111111111111111100000000000000000000001
1111000000000000000000000000000000011111111111111111111111111111111111111111100000000000000000000001
1111000000000000000000000000000000011111111111111111111111111111111111111111100000000000000000000001
1111000000000000000000000000000000011111111111111111111111111111111111111111100000000000000000000001
1111000000000000000000000000000000011111111111111111111111111111111111111111100000000000000000000001
1111000000000000000000000000000000011111111111111111111111111111111111111111100000000000000000000001
1111000000000000000000000000000000011111111111111111111111111111111111111111100000000000000000000001
1111111111111111111111111111111111111111111111111111111111111111111111111111111111111111111111111111
