38 39
000000000000000000000000000011111111111
000000000000000000000000000011111111111
000000000000000000000000000011111111111
000000000000000000000000000011111111111
000000000000000000000000000011111111111
000000000000000000000000000011111111111
000000000000000000000000000011111111111
000000000000000000000000000011111111111
000000000000000000000000000011111111111
000000000000000000000000000011111111111
000000000000000000000000000011111111111
000000000000000000000000000011111111111
000000000000000000000000000011111111111
000000000000000000000000000011111111111
000000000000000000000000000000000000000
000000000000000000000000000000000000000
000000000000000000000000000000000000000
110000000000000000000000000000000000000
110000000000000000000000000000000000000
110000000000000000000000000000000000000
110000000111110000000000000000000000000
110000000111110000000000000000000000000
110000000111110000000000000000000000000
110000000111110000000000000000000000000
110000000111110000000000000000000000000
110000000111110000000000000000000000000
110000000000000000000000000000000000000
110000000000000000000000000000000000000
110000000000000000000000000000000000000
110000000000000000000000000000000000000
110000000000000000000000000000000000000
110000000000000000000000000000000000000
110000000000000000000000000000000000000
110000000000000000000000000000000000000
110000000000000000000000000000000000000
110000000000000000000000000000000000000
110000000000000000000000000000000000000
110000000000000000000000000000000000000
