39 28
0000000000000000011111111111
0000000000000000011111111111
0000000000000000011111111111
0000000000000000011111111111
0000000000000000011111111111
0000000000000000011111111111
0000000000000000011111111111
0000000000000000011111111111
0000000000000000011111111111
0000000000000000011111111111
0000000000000000011111111111
0000000000000000011111111111
0000000000000000011111111111
0000000000000000011111111111
0000000000000000000000000000
0000000000000000000000000000
0000000000000000000000000000
1100000000000000000000000000
1100000000000000000000000000
1100000000000000000000000000
1100000000000000000000000000
1100000001111100000000000000
1100000001111100000000000000
1100000001111100000000000000
1100000001111100000000000000
1100000001111100000000000000
1100000001111100000000000000
1100000000000000000000000000
1100000000000000000000000000
1100000000000000000000000000
1100000000000000000000000000
1100000000000000000000000000
1100000000000000000000000000
1100000000000000000000000000
1100000000000000000000000000
1100000000000000000000000000
1100000000000000000000000000
1100000000000000000000000000
1100000000000000000000000000
