20 100
1111111111111111111111111111111111111111111111111111111111111111111111111111111111111111111111111111
1111111111111111111111111111111111111111111111111111111111111111111111111111111111111111111111111111
1100000111111111111111111111111111111111111111111111111111111100000000000000000000000000000000000011
1100000000000111111111111111111111111111111111111111111111111100000000000000000000000000000000000011
1100000000000000000011111111111111111111111111111111111111111100000000000000000000000000000000000011
1100000000000000000000000011111111111111111111111111111111111100000000000000000000000000000000000011
1100000000000000000000000000000001111111111111111111111111111100000000000000000000000000000000000011
1100000000000000000000000000000000000001111111111111111111111100000000000000000000000000000000000011
1100000000000000000000000000000000000000000000000000000000000000000000000000000000000000000000000011
1100000000000000000000000000000000000000000000000000000000000000000000000000000000000000000000000011
1100000000000000000000000000000000000000000000000000000000000000000000000000000000000000000000000011
1100000000000000000000000000000000000000000000000000000000000000000000000000000000000000000000000011
1100000000000000000000000000000000000000000000000000000000000000000000000000000000000000000000000011
1100000000000000000000000000000000000000000000000000000000000000000000000000000000000000000000000011
1100000000000000000000000000000000000000000000000000000000000000000000000000000000000000000000000011
1100000000000000000000000000000000000000000000000000000000000000000000000000000000000000000000000011
1111111111111111111111111111111111111111111111111111111111111111111111110000000000000000000000111111
1111111111111111111111111111111111111111111111111111111111111111111111110000000000000000000000111111
1111111111111111111111111111111111111111111111111111111111111111111111111111111111111111111111111111
1111111111111111111111111111111111111111111111111111111111111111111111111111111111111111111111111111
