87 151
1111111111111111111111111111111111111111111111111111111111111111111111111111111111111111111111111111111111111111111111111111111111111111111111111111111
1111111111111111111111111111111111111111111111111111111111111111111111111111111111111111111111111111111111111111111111111111111111111111111111111111111
1111111111111111111111111111111111111111111111111111111111111111111111111111111111111111111111111111111111111111111111111111111111111111111111111111111
1111111111111111111111111111111111111111111111111111111111111111111111111111111111111111111111111111111111111111111111111111111111111111111111111111111
1111111111111111111111111111111111111111111111111111111111111111111111111111111111111111111111111111111111111111111111111111111111111111111111111111111
1111111111111111111111111111111111111111111111111111111111111111111111111111111111111111111111111111111111111111111111111111111111111111111111111111111
1111111111111111111111111111111111111111111111111111111111111111111111111111111111111111111111111111111111111111111111111111111111111111111111111111111
1111111111111111111111111111111111111111111111111111111111111111111111111111111111111111111111111111111111111111111111111111111111111111111111111111111
1111111111111111111111111111111111111111111111111111111111111111111111111111111111111111111111111111111111111111111111111111111111111111111111111111111
1111111111111111111111111111111111111111111111111111111111111111111111111111111111111111111111111111111111111111111111111111111111111111111111111111111
1111111111111111111111111111111111111111111111111111111111111111111111111111111111111111111111111111111111111111111111111111111111111111111111111111111
1111111111111111111111111111111111111111111111111111111111111111111111111111111111111111111111111111111111111111111111111111111111111111111111111111111
1111111111111111111111111111111111111111111111111111111111111111111111111111111111111111111111111111111111111111111111111111111111111111111111111111111
1111111111111111111111111111111111111111111111111111111111111111111111111111111111111111111111111111111111111111111111111111111111111111111111111111111
1111111111111111111111111111111111111111111111111111111111111111111111111111111111111111111111111111111111111111111111111111111111111111111111111111111
1111111111111111111111111111111111111111111111111111111111111111111111111111111111111111111111111111111111111111111111111111111111111111111111111111111
1111111111111111111111111111111111111111111111111111111111111111111111111111111111111111111111111111111111111111111111111111111111111111111111111111111
1111111111111111111111111111111111111111111111111111111111111111111111111111111111111111111111111111111111111111111111111111111111111111111111111111111
1111111111111111111111111111111111111111111111111111111111111111111111111111111111111111111111111111111111111111111111111111111111111111111111111111111
1111111111111111111111111111111111111111111111111111111111111111111111111111111111111111111111111111111111111111111111111111111111111111111111111111111
1111111111111111111111111111111111111111111111111111111111111111111111111111111111111111111111111111111111111111111111111111111111111111111111111111111
1111111111111111111111111111111111111111111111111111111111111111111111111111111111111111111111111111111111111111111111111111111111111111111111111111111
1111111111111111111111111111111111111111111111111111111111111111111111111111111111111111111111111111111111111111111111111111111111111111111111111111111
1111111111111111111111111111111111111111111111111100001100000000000000000000000000000000000000000000000000000000000000000000011111111111111111111111111
1111111111111111111111111111111111111111111111111100001100000000000000000000000000000000000000000000000000000000000000000000011111111111111111111111111
1111111111111111111111111111111111111111111111111100001100000000000000000000000000000000000000000000000000000000000000000000011111111111111111111111111
1111111111111111111111111111111111111111111111111100001100000000000000000000000000000000000000000000000000000000000000000000011111111111111111111111111
1111111111111111111111111111111111111111111111111100001100000000000000000000000000000000000000000000000000000000000000000000011111111111111111111111111
1111111111111111111111111111111111111111111111111100001100000000111111111111111111111111111111111111111111111110000000000000011111111111111111111111111
1111111111111111111111111111111111111111111111111100001100000000111111111111111111111111111111111111111111111110000000000000011111111111111111111111111
1111111111111111111111111111111111111111111111111100001100000000000000000000000000000000000000000000000000000000000000000000011111111111111111111111111
1111111111111111111111111111111111111111111111111100000000000000000000000000000000000000000000000000000000000000000000000000011111111111111111111111111
1111111111111111111111111111111111111111111111111100000000000000000000000000000000000000000000000000000000000000000000000000011111111111111111111111111
1111111111111111111111111111111111111111111111111100000000000000000000000000000000000000000000000000000000000000000000000000011111111111111111111111111
1111111111111111111111111111111111111111111111111100000000000000000000000000000000000000000000000000000000000000000000000000011111111111111111111111111
1111111111111111111111111111111111111111111111111100000000000000000000000000000000000000000000000000000000000000000000000000011111111111111111111111111
1111111111111111111111111111111111111111111111111100000000011111111111111111111111111111111111111111111111111111111100000000111111111111111111111111111
1111111111111111111111111111111111111111111111111100000000011111111111111111111111111111111111111111111111111111111100000000111111111111111111111111111
1111111111111111111111111111111111111111111111111100000000011111111111111111111111111111111111111111111111111111111100000000001111000011111111111111111
1111111111111111111111111111111111111111111111111100000000011111111111111111111111111111111111111111111111111111111100000000001111000011111111111111111
1111111111111111111111111111111111111111111111111100000000011111111111111111111111111111111111111111111111111111111100000000001111000011111111111111111
1111111111111111111111111111111111111111111111111100000000011111111111111111111111111111111111111111111111111111111100000000001111000011111111111111111
1111111111111111111111111111111111111111111111111100000000011111111111111111111111111111111111111111111111111111111100000000001111000011111111111111111
1111111111111111111111111111111111111111111111111100000000011111111111111111111111111111111111111111111111111111111100000000001111000011111111111111111
1111111111111111111111111111111111111111111111111100001111111111111111111111111111111111111111111111111111111111111100000000001111000011111111111111111
1111111111111111111111111111111111111111111111111100001111111111111111111111111111111111111111111111111111111111111100000000001111000011111111111111111
1111111111111111111111111111111111111111111111111100001111111111111111111111111111111111111111111111111111111111111100000000001111000011111111111111111
1111111111111111111111111111111111111111111111111100001111111111111111111111111111111111111111111111111111111111111100000000001111000011111111111111111
1111111111111111111111111111111111111111111111111100001111111111111111111111111111111111111111111111111111111111111100000000000000000011111111111111111
1111111111111111111111111111111111111111111111111100001111111111111111111111111111111111111111111111111111111111111100000000000000000011111111111111111
1111111111111111111111111111111111111111111111111100001111111111111111111111111111111111111111111111111111111111111100000000000000000011111111000001111
1111111111111111111111111111111111111111111111111100000000011111111111111111111111111111111111111111111111111111111100000000000000000011111111000001111
1111111111111111111111111111111111111111111111111100000000011111111111111111111111111111111111111111111111111111111100000000000000000011111111000001111
1111111111111111111111111111111111111111111111111100000000011111111111111111111111111111111111111111111111111111111100000000000000000011111111000001111
1111111111111111111111111111111111111111111111111100000000011111111111111111111111111111111111111111111111111111111100000000000000000011111111000001111
1111111111111111111111111111111111111111111111111100000000011111111111111111111111111111111111111111111111111111111100000000000000000011111111000001111
1111111111111111111111111111111111111111111111111100000000011111111111111111111111111111111111111111111111111111111100000000000000000011111111000001111
1111111111111111111111111111111111111111111111111100000000011111111111111111111111111111111111111111111111111111111100000000000000000011111111000001111
1111111111111111111111111111111111111111111111111100000000000111111110000000000000000000000000000000000000111100000000000000000000000000000000000001111
1111111111111111111111111111111111111111111111111100000000000111111110000000000000000000000000000000000000111100000000000000000000000000000000000001111
1111111111111111111111111111111111111111111111111100000000000000000000000000000000000000000000000000000000000000000000000000000000000000000000000001111
1111111111111111111111111111111111111111111111111100000000000000000000000000000000000000000000000000000000000000000000000000000000000000000000000001111
1111111111111111111111111111111111111111111111111100000000000000000000000000000000000000000000000000000000000000000000000000000000000000000000000001111
1111111111111111111111111111111111111111111111111100000000000000000000000000001111111111111000000000000000000000000000000000000000000000000000000001111
1111111111111111111111111111111111111111111111111100000000000000000000000000001111111111111000000000000000000000000000000000000000000000000000000001111
1111111111111111111111111111111111111111111111111111111111111111111111111111111111111111111111111111111111111111111111111111111111111111111111111111111
1111111111111111111111111111111111111111111111111111111111111111111111111111111111111111111111111111111111111111111111111111111111111111111111111111111
1111111111111111111111111111111111111111111111111111111111111111111111111111111111111111111111111111111111111111111111111111111111111111111111111111111
1111111111111111111111111111111111111111111111111111111111111111111111111111111111111111111111111111111111111111111111111111111111111111111111111111111
1111111111111111111111111111111111111111111111111111111111111111111111111111111111111111111111111111111111111111111111111111111111111111111111111111111
1111111111111111111111111111111111111111111111111111111111111111111111111111111111111111111111111111111111111111111111111111111111111111111111111111111
1111111111111111111111111111111111111111111111111111111111111111111111111111111111111111111111111111111111111111111111111111111111111111111111111111111
1111111111111111111111111111111111111111111111111111111111111111111111111111111111111111111111111111111111111111111111111111111111111111111111111111111
1111111111111111111111111111111111111111111111111111111111111111111111111111111111111111111111111111111111111111111111111111111111111111111111111111111
1111111111111111111111111111111111111111111111111111111111111111111111111111111111111111111111111111111111111111111111111111111111111111111111111111111
1111111111111111111111111111111111111111111111111111111111111111111111111111111111111111111111111111111111111111111111111111111111111111111111111111111
1111111111111111111111111111111111111111111111111111111111111111111111111111111111111111111111111111111111111111111111111111111111111111111111111111111
1111111111111111111111111111111111111111111111111111111111111111111111111111111111111111111111111111111111111111111111111111111111111111111111111111111
1111111111111111111111111111111111111111111111111111111111111111111111111111111111111111111111111111111111111111111111111111111111111111111111111111111
1111111111111111111111111111111111111111111111111111111111111111111111111111111111111111111111111111111111111111111111111111111111111111111111111111111
1111111111111111111111111111111111111111111111111111111111111111111111111111111111111111111111111111111111111111111111111111111111111111111111111111111
1111111111111111111111111111111111111111111111111111111111111111111111111111111111111111111111111111111111111111111111111111111111111111111111111111111
1111111111111111111111111111111111111111111111111111111111111111111111111111111111111111111111111111111111111111111111111111111111111111111111111111111
1111111111111111111111111111111111111111111111111111111111111111111111111111111111111111111111111111111111111111111111111111111111111111111111111111111
1111111111111111111111111111111111111111111111111111111111111111111111111111111111111111111111111111111111111111111111111111111111111111111111111111111
1111111111111111111111111111111111111111111111111111111111111111111111111111111111111111111111111111111111111111111111111111111111111111111111111111111
1111111111111111111111111111111111111111111111111111111111111111111111111111111111111111111111111111111111111111111111111111111111111111111111111111111
