20 20
11111111111111111111
10000000000000000001
10000000000000000001
10010000000000000001
10000000001000000001
10000000000000010001
10000000000000000001
10000100000000000001
10000000000000000001
10000000000000000001
10000000000000000001
10000000000000000001
10000000000100000001
10000000000000000001
10000000000000000101
10001000000000000001
10000000000000000001
10000000000000000001
10000000000000000001
11111111111111111111
