70 120
111111111111111111111111111111111111111111111111111111111111111111111111111111111111111111111111111111111111111111111111
111111111111111111111111111111111111111111111111111111111111111111111111111111111111111111111111111111111111111111111111
111111111111111111111111111111111111111111111111111111111111111111111111111111111111111111111111111111111111111111111111
111111111111111111111111111111111111111111111111111111111111111111111111111111111111111111111111111111111111111111111111
111111111111111111111111111111111111111111111111111111111111111111111111111111111111111111111111111111111111111111111111
111111111111111111111111111111111111111111111111111111111111111111111111111111111111111111111111111111111111111111111111
111111111111111111111111111111001111111111111111111111111111111111111111111111111111111111111111111000000001111111111111
111111111111111111111111110000000001111111111111111111111111111111111111111111111111111111111111000000000000111111111111
111111111111111111111110000000000000001111111111111111111111111111111111111111111111111111111100000000000000011111111111
111111111111111111111000000000000000000111111111111111111111111111111111111111111111111111111000000000000000001111111111
111111111111111111110000000000000000000001111111111111111111111111111111111111111111111111100000000000000000001111111111
111111111111111111100000000000000000000000111111111111111111111111111111111111111111111111000000000000000000001111111111
111111111111111111000000000000000000000000000111111111111111111111111111111111111111111110000000000000000000000111111111
111111111111111110000000000000000000000000000000000011111111111111111111111111111111111100000000000000000000000111111111
111111111111111100000000000000000000000000000000000000111111111111111111111111111111111000000000000000000000000111111111
111111111111111100000000000000000000000000000000000000011111111111111111111111111111110000000000000000000000000111111111
111111111111111000000000000000000000000000000000000000011111111111111111111111111111110000000000000000000000000111111111
111111111111111000000000000000000000000000000000000000011111111111111111111111111111100000000000000000000000000111111111
111111111111111000000000000000000000000000000000000000011111111111111111111111111111000000000000000000000000000111111111
111111111111111000000000001111111100000000000000000000011111111111111111111111111111000000000000000000000000000111111111
111111111111111000000000011111111111000000000000000000011111111111111111111111111110000000000000000000000000000111111111
111111111111111000000000011111111111100000000000000000011111111111111111111111111110000000000000000000000000000111111111
111111111111111100000000011111111111110000000000000000011111111111111111111111111110000000000000000000000000000011111111
111111111111111100000000011111111111111100000000000000001111111111111111111111111100000000000000000000000000000011111111
111111111111111110000000001111111111111110000000000000001111111111111111111111111100000000000000000000000000000011111111
111111111111111110000000001111111111111111000000000000001111111111111111111111111100000000000000000000000000000011111111
111111111111111110000000000111111111111111000000000000001111111111111111111111111100000000000000000000000000000111111111
111111111111111110000000000011111111111111100000000000001111111111111111111111111100000000000000000000000000000111111111
111111111111111110000000000001111111111111110000000000000111111111111111111111111000000000000000000000000000001111111111
111111111111111110000000000000111111111111111000000000000111111111111111111111111000000000000000000000000000001111111111
111111111111111110000000000000011111111111111100000000000111111111111111111111111000000000000000000000000000011111111111
111111111111111110000000000000001111111111111100000000000111111111111111111111111000000000000000000000000000111111111111
111111111111111110000000000000000111111111111100000000000111111111111111111111111000000000000000000000000000111111111111
111111111111111110000000000000000011111111111100000000000111111111111111111111110000000000000000000000000001111111111111
111111111111111110000000000000000011111111111100000000000111111111111111111111100000000000000000000000000001111111111111
111111111111111110000000000000000001111111111000000000000111111111111111111111100000000000000000000000000011111111111111
111111111111111100000000000000000001111111111000000000000111111111111111111111000000000000000000000000000011111111111111
111111111111111100000000000000000001111111111000000000000111111111111111111111000000000000000000000000000111111111111111
111111111111111100000000000000000011111111111000000000000111111111111111111111000000000000000000000000001111111111111111
111111111111111100000000000000000111111111110000000000000111111111111111111110000000000000000000000000011111111111111111
111111111111111100000000000000001111111111110000000000000011111111111111111100000000000000000000000000011111111111111111
111111111111111100000000000000011111111111110000000000000011111111111111111100000000000000000000000000111111111111111111
111111111111111000000000000000111111111111111000000000000001111111111111111000000000000000000000000001111111111111111111
111111111111110000000000000001111111111111111000000000000001111111111111110000000000000000000000000111111111111111111111
111111111111110000000000000001111111111111111110000000000000111111111111100000000000000000000000000111111111111111111111
111111111111110000000000000011111111111111111111100000000000011111111111000000000000000000000000001111111111111111111111
111111111111100000000000000011111111111111111111100000000000000001111000000000000000000000000000011111111111111111111111
111111111111000000000000000011111111111111111111110000000000000000000000000000000000000000000000111111111111111111111111
111111111111000000000000000011111111111111111111110000000000000000000000000000000000000000000001111111111111111111111111
111111111110000000000000000011111111111111111111100000000000000000000000000000000000000000000011111111111111111111111111
111111111110000000000000000011111111111111111111000000000000000000000000000000000000000000000111111111111111111111111111
111111111100000000000000000011111111111111111111000000000000000000000000000000000000000000000111111111111111111111111111
111111111000000000000000000111111111111111111111100000000000000000000000000000000000000000001111111111111111111111111111
111111111000000000000000000111111111111111111111110000000000000000000000000000000000000000011111111111111111111111111111
111111100000000000000000001111111111111111111111110000000000000000000000000000000000000001111111111111111111111111111111
100000000000000000000000001111111111111111111111111000000000000000000000000000000000000011111111111111111111111111111111
100000000000000000000000011111111111111111111111111100000000000000000000000000000000000111111111111111111111111111111111
100000000000000000000000011111111111111111111111111100000000000000000000000000000000001111111111111111111111111111111111
100000000000000000000000011111111111111111111111111110000000000000000000000000000000011111111111111111111111111111111111
100000000000000000000000111111111111111111111111111110000000000000000000000000000000111111111111111111111111111111111111
100000000000000000000000111111111111111111111111111111000000000000000000000000000011111111111111111111111111111111111111
100000000000000000000001111111111111111111111111111111100000000000000000000000011111111111111111111111111111111111111111
100000000000000000000001111111111111111111111111111111110000000000000000000001111111111111111111111111111111111111111111
100000000000000000000011111111111111111111111111111111111110000000000000011111111111111111111111111111111111111111111111
100000000000000000000011111111111111111111111111111111111111111111111111111111111111111111111111111111111111111111111111
100000000000000000000011111111111111111111111111111111111111111111111111111111111111111111111111111111111111111111111111
100000000000000000111111111111111111111111111111111111111111111111111111111111111111111111111111111111111111111111111111
100000000000000001111111111111111111111111111111111111111111111111111111111111111111111111111111111111111111111111111111
100000000000000001111111111111111111111111111111111111111111111111111111111111111111111111111111111111111111111111111111
111111111111111111111111111111111111111111111111111111111111111111111111111111111111111111111111111111111111111111111111
